000000000000000000000000000000000000000000000000000000000000000000000000000000000000000000000000000
011101011111111111101110111111110101111111111110111011111111110101111111111110111011111111010111110
010101010110000010111011101011010101011000001011101110101101010101011000001011101110101101010101100
010101010000101110000000000011010101000010111000000000001101010101000010111000000000001101010100000
010101011110101010111111111111010101111010101011111111111101010101111010101011111111111101111111100
010111000030101010100000000001011100000010101010000000000001011100000101010100000000001011100000000
010001111000101010111111111111000111100010101011111111111101000111100010101011111111111100011110000
011111101111111010100001000001111110111111101010000100000101111110111111101010000100000111111011110
000000100000000010011111111110000010000000001001111111111100000010000000001001111111111000001000000
011111101110111111110011100001111110111011111111001110000101111110111011111111001110000111111011100
010000001010100000011000001111000000101010000001100000111101000000101010000001100000111100000010100
011111111010001111001111111011111111101000111100111111101101111111101000111100111111101111111110100
000100000011111001011100000010010000001111100101110000001100010000001111100101110000001001000000110
010001111010001001110111111110000111101000100111011111111101000111101000100111011111111100011110100
011111000011101000000101010010111000011101000000101010111011111000011101000000101010111111100001100
010101111010101111110000000010010111101001111111000000001101010111011010111111000000001101011110100
010101000000000000011111111110010100000000000001111111111101010100000000000001111111111101010000000
010011111011111111000000000010011111101111111100000000001101011111101111111100000000001100111110110
010110001010000101111111111110011000101000010111111111111101011000101000010111111111111101100010100
010010101011110100000000000010001010101111010000000000001101001010101111010000000000001100101010110
000111101110010111110111111110011110111001011111011111111100011110111001011111011111111001111011100
000000000000000000000000000000000000000000000000000000000000000000000000000000000000000000000000000
